XX XXXXX XXXXXXXXXXXXXX XXXX
X  XXXXX XXXXXXXXXXXXXX XXXX
X XXXXXX     XXXXXX       XX
X XXXXXXXX XXXXXXXXXX XXXXXX
X  XXXXXXXXXXXXXXXXXX XXXXXX
XX XXXXXXXXXXXXXXXXXX XXXXXX
------
2: 2
8: 
23: 21